11111111111111111111
10000000000010000001
10111011111110111101
10000011100010000001
11111011111110111101
10000000000000000001
10111111101110111101
10010001100010000001
10111111111110111101
10001000011001000001
10101111111110111101
10000000000010000001
11111111111111111111

/* game map */
